111111001111
100000000011
100111110011
100000010111
100100000011
111101111111
100101000011
101101010011
100000010011
111111111111
